MM                                                                                                                                            MM 
MM                               1                                                                                                            MM 
MM   1                                                                            1                        1              1                   MM 
MM                    1                                     1                                                                                 MM 
MM                                         1                        1                           1                                             MM 
MM         1                                                                         1                                      1                 MM 
MM                                                   1                                                         aaaaaaa                        MM 
MM                  1                                                                                     1    MMMMMMM                        MM 
MM  e                         eaaaaa                                                                           MMMMMMM                        MM 
MMMMMMMM                   MMMMMMMMM                                   aaaaaaaaaaa              e     mm                                      MM 
MMMMMMMM                   MMMMMMMMM                                   aaaaaaaaaaam            MMMMMMMMM                  m aaa               MM 
MM                                           eaaamm        aa         MMMMMMMMMMMMMM           MMMMMMMMM                 MMMMMMM              MM 
MM                    amm                 MMMMMMMMMM      MMMM        MMMMMMMMMMMMMM                                     MMMMMMM Ma           MM 
MM                   aMMM                 MMMMMMMMMM      MMMM                                                                   MMa          MM 
MM                  aMMMM                                                                                                         MMa         MM 
MM                aaMMM                                                                                                           MMMa        MM 
MM       mm  MMMMMMMMMM                                                                                                            MMMa       MM 
MMMMMMMMMMMMMMMMMMMMMMMppppppppppppppppppppppppppppppppppppppppppppppppppppppppppppppppppppppppppppppppppppppppppppppppppppppppppppMMMMa      MM 
MMMMMMMMMMMMMMMMMMMMMMMMMMMMMMMMMMMMMMMMMMMMMMMMMMMMMMMMMMMMMMMMMMMMMMMMMMMMMMMMMMMMMMMMMMMMMMMMMMMMMMMMMMMMMMMMMMMMMMMMMMMMMMMMMMMMMMMMMMMMMMMM 
MMMMMMMMMMMMMMMMMMMMMMMMMMMMMMMMMMMMMMMMMMMMMMMMMMMMMMMMMMMMMMMMMMMMMMMMMMMMMMMMMMMMMMMMMMMMMMMMMMMMMMMMMMMMMMMMMMMMMMMMMMMMMMMMMMMMMMMMMMMMMMMM 
MMMMMMMMMMMMMMMMMMMMMMMMMMMMMMMMMMMMMMMMMMMMMMMMMMMMMMMMMMMMMMMMMMMMMMMMMMMMMMMMMMMMMMMMMMMMMMMMMMMMMMMMMMMMMMMMMMMMMMMMMMMMMMMMMMMMMMMMMMMMMMMM 
MMMMMMMMMMMMMMMMMMMMMMMMMMMMMMMMMMMMMMMMMMMMMMMMMMMMMMMMMMMMMMMMMMMMMMMMMMMMMMMMMMMMMMMMMMMMMMMMMMMMMMMMMMMMMMMMMMMMMMMMMMMMMMMMMMMMMMMMMMMMMMMM 
MMMMMMMMMMMMMMMMMMMMMMMMMMMMMMMMMMMMMMMMMMMMMMMMMMMMMMMMMMMMMMMMMMMMMMMMMMMMMMMMMMMMMMMMMMMMMMMMMMMMMMMMMMMMMMMMMMMMMMMMMMMMMMMMMMMMMMMMMMMMMMMM 
MMMMMMMMMMMMMMMMMMMMMMMMMMMMMMMMMMMMMMMMMMMMMMMMMMMMMMMMMMMMMMMMMMMMMMMMMMMMMMMMMMMMMMMMMMMMMMMMMMMMMMMMMMMMMMMMMMMMMMMMMMMMMMMMMMMMMMMMMMMMMMMM
